SO ./img/bomb.xpm
F 163,		121,6
WE ./img/up.xpm
NO    ./img/left.xpm

C 0,   146,255


EA ./img/left.xpm



1111   1111
1001   1001
10011111001
10000000001
10000W00001
11100000111
  1000001
  1000001
11100000111
10000000001
10000111001
100001 1001
111111 1111
    
				


