SO ./img/bomb.xpm
F 163,		121,6
NO ./img/test.xpm


WE ./img/up.xpm

EA ./img/left.xpm

C 0,   146,255

111111111111111
100000000000001
111111111111101
100000000000101
101111111110101
101000000010101
101011111010101
101010001010101
101010N01010101
101010000010101
101011111110101
101000000000101
101111111111101
100000000000001
111111111111111
    
				


