1111111111111111111111111111111
1AP00C111AC100C000000C111111111
11C0001100000111111111A00000E11
1110011C00100000AC0000000011111
110A001000110000111111111001111
11100C1A01111000000C000010A0011
11C0000001111CA0000000000000C11
1111111111111111111111111111111
1111111111111111111111111111111
