11111111111111111111111111111111111
1C111000010000110001111000000000AE1
10111011000110100101100011111A00001
10111011111100A01101101100000C00001
10001011111101100101101101111110111
111000C100010111010110110C1C0110111
11101111010100000100101111110110111
11100000010111111110001110A00110111
1111110111010001110AP00C10001110001
1A000100C1000100001000111A001111101
10010111111111111011011111011111101
10110000000000000000000000011111101
10111111111111111111111111111101101
100001111111101111000001111110A0101
11110111111101111111110111111000101
11000111111011111100000111111011101
11C111111100001111011111111110000C1
11111111111110111100000111111111111
11111111111111111111111111111111111
