NO ./img/test.xpm
SO ./img/bomb.xpm
WE ./img/up.xpm
EA ./img/left.xpm
F 250,100,0
C 255,0,255
		1111111111111111111111111
		1000000000110000000000001
		1011000001110000000000001
		1001000000000000000000001
111111111011000001110000000000001
100000000011000001110111111111111
11110111111111011100000010001
1111011111111101110101001000111111
1100000011010101110000000000000001
1000000000000000110000000000100001
1000000000000000110101000000000001
11000001110101011111011100N0100011
1100000011010101110000000000000001
1000000000000000110000000000100001
1000000000000000110101000000000001
1111011111110101110111101000000001
11111111 1111111 11111111111111111
