SO ./path_to_the_south_texture
F 163,		121,6
NO ./path_to_the_north_texture


WE ./path_to_the_west_texture

EA ./path_to_the_east_texture

C 0,   146,255



		111111111111111111111111
		100000000000000000000001
		100000000000000000000001
		100000000000000111111111
111111111110000101010001
100000100010000000000001
100000100010000100010001
100000100010000000000001
100000110110000101010001
100000000000000000000001
100000000000000000000001
100000000000000000000001
100000000000000000000001
100000000000000000000001
100000000000000000000001
100000000000000000000001
111111111000000000000001
110100001000000000000001
110000N01000000000000001
110100001000000000000001
110111111000000000000001
110000000000000000000001
111111111000000000000001
111111111111111111111111
