NO ./path_to_the_north_texture
SO ./path_to_the_south_texture
WE ./path_to_the_west_texture
EA ./path_to_the_east_texture
F 163,121,6
C 0,246,255
11111
10001
10101
10001
10001
10N01
10001
11111
