SO ./path_to_the_south_texture
F 163,		121,6
NO ./path_to_the_north_texture


WE ./path_to_the_west_texture

EA ./path_to_the_east_texture

C 0,   146,255

11111111111111111111111111111111111111111111111111111111111111111111111111111
10000000000000000000000000000000000000000000000000000000000000000000000000001
10000000000000000000000000000000000000000000000000000000000000000000000000001
10001111111111111111111111111111111111111111111111111111111111111111111111111
10001
10001
10001   111111111111111111111111111111111111111111111111111111111111111111111
10001   100000000000000000000000000000000000000000000000000000000000000000001
10001   100000000000000000000000000000000000000000000000000000000000000000001
10001   100011111111111111111111111111111111111111111111111111111111111110001
10001   10001                                                           10001
10001   10001                                                           10001
10001   10001   11111111111111111111111111111111111111111111111111111   10001
10001   10001   10000000000000000000000000000000000000000000000000001   10001
10001   10001   10000000000000000000000000000000000000000000000000001   10001
10001   10001   10001111111111111111111111111111111111111111111110001   10001
10001   10001   10001                                           10001   10001
10001   10001   10001                                           10001   10001
10001   10001   10001   1111111111111111111111111111111111111   10001   10001
10001   10001   10001   1000000000000000000000000000000000001   10001   10001
10001   10001   10001   1000000000000000000000000000000000001   10001   10001
10001   10001   10001   1000111111111111111111111111111110001   10001   10001
10001   10001   10001   10001                           10001   10001   10001
10001   10001   10001   10001                           10001   10001   10001
10001   10001   10001   10001   111111111111111111111   10001   10001   10001
10001   10001   10001   10001   100000000000000000001   10001   10001   10001
10001   10001   10001   10001   100000000000000000001   10001   10001   10001
10001   10001   10001   10001   100011111111111110001   10001   10001   10001
10001   10001   10001   10001   10001           10001   10001   10001   10001
10001   10001   10001   10001   10001           10001   10001   10001   10001
10001   10001   10001   10001   10001   11111   10001   10001   10001   10001
10001   10001   10001   10001   10001   10001   10001   10001   10001   10001
10001   10001   10001   10001   10001   10N01   10001   10001   10001   10001
10001   10001   10001   10001   10001   10001   10001   10001   10001   10001
10001   10001   10001   10001   1000111110001   10001   10001   10001   10001
10001   10001   10001   10001   1000000000001   10001   10001   10001   10001
10001   10001   10001   10001   1000000000001   10001   10001   10001   10001
10001   10001   10001   10001   1111111111111   10001   10001   10001   10001
10001   10001   10001   10001                   10001   10001   10001   10001
10001   10001   10001   10001                   10001   10001   10001   10001
10001   10001   10001   10001111111111111111111110001   10001   10001   10001
10001   10001   10001   10000000000000000000000000001   10001   10001   10001
10001   10001   10001   10000000000000000000000000001   10001   10001   10001
10001   10001   10001   11111111111111111111111111111   10001   10001   10001
10001   10001   10001                                   10001   10001   10001
10001   10001   10001                                   10001   10001   10001
10001   10001   100011111111111111111111111111111111111110001   10001   10001
10001   10001   100000000000000000000000000000000000000000001   10001   10001
10001   10001   100000000000000000000000000000000000000000001   10001   10001
10001   10001   111111111111111111111111111111111111111111111   10001   10001
10001   10001                                                   10001   10001
10001   10001                                                   10001   10001
10001   1000111111111111111111111111111111111111111111111111111110001   10001
10001   1000000000000000000000000000000000000000000000000000000000001   10001
10001   1000000000000000000000000000000000000000000000000000000000001   10001
10001   1111111111111111111111111111111111111111111111111111111111111   10001
10001                                                                   10001
10001                                                                   10001
10001111111111111111111111111111111111111111111111111111111111111111111110001
10000000000000000000000000000000000000000000000000000000000000000000000000001
10000000000000000000000000000000000000000000000000000000000000000000000000001
11111111111111111111111111111111111111111111111111111111111111111111111111111
