SO        ./img/bomb.xpm
F 163,		121,6
NO    ./img/dale_jaune.xpm
WE ./img/down.xpm
EA ./img/fond.xpm
C 0,   146,255
        111111111111111111111111
        100000000000000000000001
        100000000000000000000001
        100000000000000111111111
111111111000000101010001
100000100010000000000001
100000100010000100010001
100000100010000000000001
1111100110110000101010011
100000000000000000000001
111110000000000000000001
100000000000000000000011
111111111111000000000001
100000000000000000000001
111111111111100000000001
100000000000000000000001
111111111000000000000001
110100001000000000000001
1100000000000000000N0001
110100001000000000000001
110111111000000000000001
110000000000000000000001
111111111000000000000001
111111111111111111111111
