NO ./img/up.xpm
SO ./img/up.xpm
WE ./img/up.xpm
EA ./img/up.xpm
F 163,121,6
C 0,246,255

11111
10001
10001
10001
10001
10N01
10001
11111
