SO ./path_to_the_south_texture
F 163,		121,6
NO ./path_to_the_north_texture


WE ./path_to_the_west_texture

EA ./path_to_the_east_texture

C 0,   146,255

              11111 11111    111
              10001110001    101
              10000000001    101
        111111100000000011111101 	 
        100000000000000000000001
        100000000000000000000001
        100000000000000111111111
111111111110000101010001
100000100010000000000001
100000100010000100010001
100000100010000000000001
1111100110110000101010011111
    100000000000000000000001
    1111100000000000000000011
        100000000000000000001
        100000000000000111111
111111111100000000000001
100000000000000000000001
111100000111100000000001111
   100001100000000000000001
111111111000000000000001111
110100001000000000000001
110000N00000000000000001
110100001000000000000001
110111111000000000000001
110000000111110000000001
1110000001   10000000001
1111111111   11111111111

    
				


