NO ./img/black_window.xpm
SO ./img/house_open.xpm
EA ./img/bomb.xpm
WE ./img/test.xpm

F 13,121,6
C 0,246,255

11111
10001
10N01
10001
11111