SO ./img/bomb.xpm
F 163,		121,6
NO ./img/test.xpm


WE ./img/up.xpm

EA ./img/left.xpm

C 0,   146,255

111111111111111111111111111111
100000000000000000000000000001
101111111111111111111111111101
101000100010001100000000000101
101010101010101101111111110101
101010101010101101000000010101
101010101010101101011111010101
101010101010101101010001010101
101010101010101101010N01010101
101010101010101101010000010101
101010101010101101011111110101
101010101010101101000000000101
101010101010101101111111111101
100010001000101100000000000001
111111111111101111111111111111
100000000000001100000000000001
101111111111111111111111111101
101000000000011110000000000101
101011111111011110111111110101
101010000000011110000000010101
101010111111111111111111010101
101010000000000000000000010101
100011111111111111111111110001
111111111111111111111111111111

