11111111111
10C0CE00001
10000000001
1000000P001
10000000001
11111111111
