1111111111111111111111111111111
10P00C1110C100C000000C111111111
11C0001100000111111111000000E11
1110011C001000000C0000000011111
1100001000110000111111111001111
11100C1001111000000C00001000011
11C0000001111C00000000000000C11
1111111111111111111111111111111
1111111111111111111111111111111
