SO ./path_to_the_south_texture
F 163,		121,6
NO ./path_to_the_north_texture


WE ./path_to_the_west_texture

EA ./path_to_the_east_texture

C 0,   146,255

1111   1111
1001   1001
10011111001
10000000001
10000N00001
11100000111
  1000001
  1000001
11100000111
10000000001
10000111001
100001 1001
111111 1111
    
				


