SO ./path_to_the_south_texture
F 163,		121,6
NO ./path_to_the_north_texture


WE ./path_to_the_west_texture

EA ./path_to_the_east_texture

C 0,   146,255

111111111111111111111111111111
100000000000000000000000000001
101111111111111111111111111101
101000000000001100000000000101
101011111111101101111111110101
101010000000101101000000010101
101010111110101101011111010101
101010100010101101010001010101
101010101010101101010N01010101
101010101010101101010000010101
101010101110101101011111110101
101010100000101101000000000101
101010111111101101111111111101
100010000000001100000000000001
111111111111111111111111111111
    
				


